BBBBBBBBBBBBBBBBBBBB
BBBBBBBBBBBBBBBBBBBB
BBBBBBBBRRRRRRBBBBBB
BBBBBBBBRRRRRRBBBBBB
BBBBBBBBRRRRRRBBBBBB
BBBBBBBBRRRRRRBBBBBB
BBBBBBBBRRRRRRBBBBBB
BBBBBBBBRRRRRRBBBBBB
BBBBBBBBBBBBBBBBBBBB
BBBBBBBBBBBBBBBBBBBB
RRRRRRRRRRRRRRRRRRRR
RRRRRRRRRRRRRRRRRRRR
RRRRRRRRBBBBBBRRRRRR
RRRRRRRRBBBBBBRRRRRR
RRRRRRRRBBBBBBRRRRRR
RRRRRRRRBBBBBBRRRRRR
RRRRRRRRBBBBBBRRRRRR
RRRRRRRRBBBBBBRRRRRR
RRRRRRRRRRRRRRRRRRRR
RRRRRRRRRRRRRRRRRRRR