XXXXXXXXXXXXXXXXXXXX
XBBBBBBBBBBBBBBBBBBX
XBBBBBBBRRRRRRBBBBBX
XBBBBBBBRRRRRRBBBBBX
XBBBBBBBRRRRRRBBBBBX
XBBBBBBBRRRRRRBBBBBX
XBBBBBBBRRRRRRBBBBBX
XBBBBBBBRRRRRRBBBBBX
XBBBBBBBBBBBBBBBBBBX
XBBBBBBBBBBBBBBBBBBX
XRRRRRRRRRRRRRRRRRRX
XRRRRRRRRRRRRRRRRRRX
XRRRRRRRBBBBBBRRRRRX
XRRRRRRRBBBBBBRRRRRX
XRRRRRRRBBBBBBRRRRRX
XRRRRRRRBBBBBBRRRRRX
XRRRRRRRBBBBBBRRRRRX
XRRRRRRRBBBBBBRRRRRX
XRRRRRRRRRRRRRRRRRRX
XXXXXXXXXXXXXXXXXXXX