BBBBBBBBBBBBBBBBBBBB
RRBBBBBBBBBBBBBBBBRR
RRRRBBBBBBBBBBBBRRRR
RRRRRRBBBBBBBBRRRRRR
RRRRRRRRBBBBRRRRRRRR
BBBBBBBBRRRRRRBBBBBB
BBBBBBBBRRRRRRBBBBBB
BBBBBBBBRRRRRRBBBBBB
BBBBBBBBBBBBBBBBBBBB
BBBBBBBBBBBBBBBBBBBB
RRRRRRRRRRRRRRRRRRRR
RRRRRRRRRRRRRRRRRRRR
RRRRRRRRBBBBBBRRRRRR
RRRRRRRRBBBBBBRRRRRR
RRRRRRRRBBBBBBRRRRRR
RRRRRRRRBBBBBBRRRRRR
RRRRRRRRBBBBBBRRRRRR
RRRRRRRRBBBBBBRRRRRR
RRRRRRRRRRRRRRRRRRRR
RRRRRRRRRRRRRRRRRRRR