XXXXXXXXXXXXXXXXXXXX
XBBBBBBBBBBBBBBBBBBX
XBBBBBBBBBBBBBBBBBBX
XBBBBBBBBBBBBBBBBBBX
XBBBBBBBBBBBBBBBBBBX
XPPPPPPPPPPPPPPPPPPX
XPPPPPPPPPPPPPPPPPPX
XPPPPPPPPPPPPPPPPPPX
XPPPPPPPPPPPPPPPPPPX
XPPPPPPPPPPPPPPPPPPX
XPPPPPPPPPPPPPPPPPPX
XPPPPPPPPPPPPPPPPPPX
XPPPPPPPPPPPPPPPPPPX
XPPPPPPPPPPPPPPPPPPX
XPPPPPPPPPPPPPPPPPPX
XRRRRRRRRRRRRRRRRRRX
XRRRRRRRRRRRRRRRRRRX
XRRRRRRRRRRRRRRRRRRX
XRRRRRRRRRRRRRRRRRRX
XXXXXXXXXXXXXXXXXXXX