XXXXXXXXXXXXXXXXXXXX
XBBBBBBBBBBBBBBBBBBX
XBBBBBBBBBBBBBBBBBBX
XRRRRRRRPPPPRRRRRRRX
XRRRRRRRPPPPRRRRRRRX
XRRRRRRRPPPPRRRRRRRX
XRRRRRRRPPPPRRRRRRRX
XRRRRRRRYYYYRRRRRRRX
XRRRRRRRYYYYRRRRRRRX
XBBBBBBBYYYYBBBBBBBX
XBBBBBBBYYYYBBBBBBBX
XRRRRRRRYYYYRRRRRRRX
XRRRRRRRYYYYRRRRRRRX
XRRRRRRRYYYYRRRRRRRX
XRRRRRRRPPPPRRRRRRRX
XRRRRRRRPPPPRRRRRRRX
XRRRRRRRPPPPRRRRRRRX
XBBBBBBBBBBBBBBBBBBX
XBBBBBBBBBBBBBBBBBBX
XXXXXXXXXXXXXXXXXXXX