XXXXXXXXXXXXXXXXXXXX
XBBBBBBBBBBBBBBBBBBX
XBBBBBBBBBBBBBBBBBBX
XRRRRRRRRRRRRRRRRRRX
XRRRBBRRRBBRRRBBRRRX
XRRRBBRRRBBRRRBBRRRX
XRRRRRRRRRRRRRRRRRRX
XRRRRRRRRRRRRRRRRRRX
XPPPPPPPPPPPPPPPPPPX
XPPPRRPPPRRPPPRRPPPX
XPPPRRPPPRRPPPRRPPPX
XPPPPPPPPPPPPPPPPPPX
XRRRRRRRRRRRRRRRRRRX
XRRRRRRRRRRRRRRRRRRX
XRRRBBRRRBBRRRBBRRRX
XRRRBBRRRBBRRRBBRRRX
XRRRRRRRRRRRRRRRRRRX
XBBBBBBBBBBBBBBBBBBX
XBBBBBBBBBBBBBBBBBBX
XXXXXXXXXXXXXXXXXXXX