XXXXXXXXXXXXXXXXXXXX
XBBBBBBBBBBBBBBBBBBX
XRRRRRRRRRRRRRRRRRRX
XRBBRRRBBRRRRRBBRRRX
XRBBRRRBBRRRRRBBRRRX
XRRRRRRRRRRRRRRRRRRX
XRRRRRRRRRRRRRRRRRRX
XRRRRRRRRRRRRRRRRRRX
XPPPPPPPPPPPPPPPPPPX
XPRRPPPRRPPPPPRRPPPX
XPRRPPPRRPPPPPRRPPPX
XPPPPPPPPPPPPPPPPPPX
XRRRRRRRRRRRRRRRRRRX
XRRRRRRRRRRRRRRRRRRX
XRRRRRRRRRRRRRRRRRRX
XRBBRRRBBRRRRRBBRRRX
XRBBRRRBBRRRRRBBRRRX
XRRRRRRRRRRRRRRRRRRX
XBBBBBBBBBBBBBBBBBBX
XXXXXXXXXXXXXXXXXXXX