XXXXXXXXXXXXXXXXXXXX
XRRBBBBRRRRRRBBBBRRX
XRRBBBBYYYYYYBBBBRRX
XRRBBBBYYYYYYBBBBRRX
XRRBBBBYYYYYYBBBBRRX
XRRBBBBYYYYYYBBBBRRX
XRRBBBBRRRRRRBBBBRRX
XRRBBBBRRRRRRBBBBRRX
XRRBBBBYYYYYYBBBBRRX
XRRBBBBYYYYYYBBBBRRX
XRRBBBBYYYYYYBBBBRRX
XRRBBBBYYYYYYBBBBRRX
XRRBBBBRRRRRRBBBBRRX
XRRBBBBRRRRRRBBBBRRX
XRRBBBBYYYYYYBBBBRRX
XRRBBBBYYYYYYBBBBRRX
XRRBBBBYYYYYYBBBBRRX
XRRBBBBYYYYYYBBBBRRX
XRRBBBBRRRRRRBBBBRRX
XXXXXXXXXXXXXXXXXXXX
