BBBBBBBBBBBBBBBBBBBB
BBBBBBBBBBBBBBBBBBBB
BBBBBBBBYYYYYYBBBBBB
BBBBBBBBYYYYYYBBBBBB
BBBBBBBBYYYYYYBBBBBB
BBBBBBBBYYYYYYBBBBBB
BBBBBBBBYYYYYYBBBBBB
BBBBBBBBYYYYYYBBBBBB
BBBBBBBBBBBBBBBBBBBB
YYYYYYYYYYYYYYYYYYYY
YYYYYYYYYYYYYYYYYYYY
RRRRRRRRRRRRRRRRRRRR
RRRRRRRRRRRRRRRRRRRR
RRRRRRRRBBBBBBRRRRRR
RRRRRRRRBBBBBBRRRRRR
RRRRRRRRBBBBBBRRRRRR
RRRRRRRRBBBBBBRRRRRR
RRRRRRRRBBBBBBRRRRRR
RRRRRRRRBBBBBBRRRRRR
RRRRRRRRRRRRRRRRRRRR
